1 1 1 2 2 2 3 3 3 4 4 4 5 5 5 81 86 
6 6 6 7 7 7 8 8 8 9 9 9 10 10 10 81 86 
11 11 11 12 12 12 13 13 13 14 14 14 15 15 15 81 86 
16 16 16 17 17 17 18 18 18 19 19 19 20 20 20 82 87 
21 21 21 22 22 22 23 23 23 24 24 24 25 25 25 82 87 
26 26 26 27 27 27 28 28 28 29 29 29 30 30 30 82 87 
31 31 31 32 32 32 33 33 33 34 34 34 35 35 35 83 88 
36 36 36 37 37 37 38 38 38 39 39 39 40 40 40 83 88 
41 41 41 42 42 42 43 43 43 44 44 44 45 45 45 83 88 
46 46 46 47 47 47 48 48 48 49 49 49 50 50 50 84 89 
51 51 51 52 52 52 53 53 53 54 54 54 55 55 55 84 89 
56 56 56 57 57 57 58 58 58 59 59 59 60 60 60 84 89 
61 61 61 62 62 62 63 63 63 64 64 64 65 65 65 85 90 
66 66 66 67 67 67 68 68 68 69 69 69 70 70 70 85 90 
71 71 71 72 72 72 73 73 73 74 74 74 75 75 75 85 90 
76 76 76 77 77 77 78 78 78 79 79 79 80 80 80 0 0

1 1 1 2 2 2 9 
3 3 3 4 4 4 9 
5 5 5 6 6 6 9 
7 7 7 8 8 8 0

1 1 1 2 2 2 3 3 3 4 4 4 25 
5 5 5 6 6 6 7 7 7 8 8 8 25 
9 9 9 10 10 10 11 11 11 12 12 12 25 
13 13 13 14 14 14 15 15 15 16 16 16 26 
17 17 17 18 18 18 19 19 19 20 20 20 26 
21 21 21 22 22 22 23 23 23 24 24 24 26 

1 1 1 2 2 2 
3 3 3 4 4 4 
5 5 5 6 6 6 
7 7 7 8 8 8 
9 9 9 10 10 10 
11 11 11 12 12 12 
13 13 13 14 14 14 
15 15 15 16 16 16 
17 17 17 18 18 18 
19 19 19 20 20 20 
21 21 21 22 22 22 
23 23 23 24 24 24 
25 25 25 26 26 26 
27 27 27 28 28 28 
29 29 29 30 30 30 
31 31 31 32 32 32 
33 33 33 34 34 34 
35 35 35 36 36 36 

1 1 1 2 2 2 3 3 3 4 4 4 5 5 5 41 
6 6 6 7 7 7 8 8 8 9 9 9 10 10 10 41 
11 11 11 12 12 12 13 13 13 14 14 14 15 15 15 41 
16 16 16 17 17 17 18 18 18 19 19 19 20 20 20 42 
21 21 21 22 22 22 23 23 23 24 24 24 25 25 25 42 
26 26 26 27 27 27 28 28 28 29 29 29 30 30 30 42 
31 31 31 32 32 32 33 33 33 34 34 34 35 35 35 0
36 36 36 37 37 37 38 38 38 39 39 39 40 40 40 0

1 1 1 17 22 
2 2 2 17 22 
3 3 3 17 22 
4 4 4 18 23 
5 5 5 18 23 
6 6 6 18 23 
7 7 7 19 24 
8 8 8 19 24 
9 9 9 19 24 
10 10 10 20 25 
11 11 11 20 25 
12 12 12 20 25 
13 13 13 21 26 
14 14 14 21 26 
15 15 15 21 26 
16 16 16 0 0

1 1 1 2 2 2 3 3 3 4 4 4 5 5 5 76 81 
6 6 6 7 7 7 8 8 8 9 9 9 10 10 10 76 81 
11 11 11 12 12 12 13 13 13 14 14 14 15 15 15 76 81 
16 16 16 17 17 17 18 18 18 19 19 19 20 20 20 77 82 
21 21 21 22 22 22 23 23 23 24 24 24 25 25 25 77 82 
26 26 26 27 27 27 28 28 28 29 29 29 30 30 30 77 82 
31 31 31 32 32 32 33 33 33 34 34 34 35 35 35 78 83 
36 36 36 37 37 37 38 38 38 39 39 39 40 40 40 78 83 
41 41 41 42 42 42 43 43 43 44 44 44 45 45 45 78 83 
46 46 46 47 47 47 48 48 48 49 49 49 50 50 50 79 84 
51 51 51 52 52 52 53 53 53 54 54 54 55 55 55 79 84 
56 56 56 57 57 57 58 58 58 59 59 59 60 60 60 79 84 
61 61 61 62 62 62 63 63 63 64 64 64 65 65 65 80 85 
66 66 66 67 67 67 68 68 68 69 69 69 70 70 70 80 85 
71 71 71 72 72 72 73 73 73 74 74 74 75 75 75 80 85 

1 1 1 2 2 2 3 3 3 49 54 
4 4 4 5 5 5 6 6 6 49 54 
7 7 7 8 8 8 9 9 9 49 54 
10 10 10 11 11 11 12 12 12 50 55 
13 13 13 14 14 14 15 15 15 50 55 
16 16 16 17 17 17 18 18 18 50 55 
19 19 19 20 20 20 21 21 21 51 56 
22 22 22 23 23 23 24 24 24 51 56 
25 25 25 26 26 26 27 27 27 51 56 
28 28 28 29 29 29 30 30 30 52 57 
31 31 31 32 32 32 33 33 33 52 57 
34 34 34 35 35 35 36 36 36 52 57 
37 37 37 38 38 38 39 39 39 53 58 
40 40 40 41 41 41 42 42 42 53 58 
43 43 43 44 44 44 45 45 45 53 58 
46 46 46 47 47 47 48 48 48 0 0

1 1 1 15 
2 2 2 15 
3 3 3 15 
4 4 4 16 
5 5 5 16 
6 6 6 16 
7 7 7 17 
8 8 8 17 
9 9 9 17 
10 10 10 18 
11 11 11 18 
12 12 12 18 
13 13 13 0
14 14 14 0

1 1 1 2 2 2 3 3 3 4 4 4 5 5 5 91 97 
6 6 6 7 7 7 8 8 8 9 9 9 10 10 10 91 97 
11 11 11 12 12 12 13 13 13 14 14 14 15 15 15 91 97 
16 16 16 17 17 17 18 18 18 19 19 19 20 20 20 92 98 
21 21 21 22 22 22 23 23 23 24 24 24 25 25 25 92 98 
26 26 26 27 27 27 28 28 28 29 29 29 30 30 30 92 98 
31 31 31 32 32 32 33 33 33 34 34 34 35 35 35 93 99 
36 36 36 37 37 37 38 38 38 39 39 39 40 40 40 93 99 
41 41 41 42 42 42 43 43 43 44 44 44 45 45 45 93 99 
46 46 46 47 47 47 48 48 48 49 49 49 50 50 50 94 100 
51 51 51 52 52 52 53 53 53 54 54 54 55 55 55 94 100 
56 56 56 57 57 57 58 58 58 59 59 59 60 60 60 94 100 
61 61 61 62 62 62 63 63 63 64 64 64 65 65 65 95 101 
66 66 66 67 67 67 68 68 68 69 69 69 70 70 70 95 101 
71 71 71 72 72 72 73 73 73 74 74 74 75 75 75 95 101 
76 76 76 77 77 77 78 78 78 79 79 79 80 80 80 96 102 
81 81 81 82 82 82 83 83 83 84 84 84 85 85 85 96 102 
86 86 86 87 87 87 88 88 88 89 89 89 90 90 90 96 102 

