1 1 1 2 2 2 3 3 3 
4 4 4 5 5 5 6 6 6 
7 7 7 8 8 8 9 9 9 
10 10 10 11 11 11 12 12 12 
13 13 13 14 14 14 15 15 15 
16 16 16 17 17 17 18 18 18 
19 19 19 20 20 20 21 21 21 
22 22 22 23 23 23 24 24 24 
25 25 25 26 26 26 27 27 27 
28 28 28 29 29 29 30 30 30 
31 31 31 32 32 32 33 33 33 
34 34 34 35 35 35 36 36 36 

1 1 1 2 2 2 3 3 3 4 4 4 0 0 
5 5 5 6 6 6 7 7 7 8 8 8 0 0 
9 9 9 10 10 10 11 11 11 12 12 12 0 0 
13 13 13 14 14 14 15 15 15 16 16 16 0 0 
17 17 17 18 18 18 19 19 19 20 20 20 0 0 
21 21 21 22 22 22 23 23 23 24 24 24 0 0 
25 25 25 26 26 26 27 27 27 28 28 28 0 0 
29 29 29 30 30 30 31 31 31 32 32 32 0 0 
33 33 33 34 34 34 35 35 35 36 36 36 0 0 
37 37 37 38 38 38 39 39 39 40 40 40 0 0 
41 41 41 42 42 42 43 43 43 44 44 44 0 0 
45 45 45 46 46 46 47 47 47 48 48 48 0 0 

1 1 1 0 0 
2 2 2 0 0 
3 3 3 0 0 
4 4 4 0 0 
5 5 5 0 0 
6 6 6 0 0 
7 7 7 0 0 
8 8 8 0 0 
9 9 9 0 0 
10 10 10 0 0 
11 11 11 0 0 
12 12 12 0 0 
13 13 13 0 0 

1 1 1 2 2 2 3 3 3 0 0 
4 4 4 5 5 5 6 6 6 0 0 
7 7 7 8 8 8 9 9 9 0 0 
10 10 10 11 11 11 12 12 12 0 0 
13 13 13 14 14 14 15 15 15 0 0 
16 16 16 17 17 17 18 18 18 0 0 
19 19 19 20 20 20 21 21 21 0 0 

1 1 1 0 
2 2 2 0 
3 3 3 0 
4 4 4 0 
5 5 5 0 
6 6 6 0 
7 7 7 0 
8 8 8 0 
9 9 9 0 
10 10 10 0 
11 11 11 0 
12 12 12 0 
13 13 13 0 
14 14 14 0 
15 15 15 0 

1 1 1 2 2 2 3 3 3 0 
4 4 4 5 5 5 6 6 6 0 
7 7 7 8 8 8 9 9 9 0 
10 10 10 11 11 11 12 12 12 0 
13 13 13 14 14 14 15 15 15 0 
16 16 16 17 17 17 18 18 18 0 
19 19 19 20 20 20 21 21 21 0 
22 22 22 23 23 23 24 24 24 0 

1 1 1 2 2 2 3 3 3 0 0 
4 4 4 5 5 5 6 6 6 0 0 
7 7 7 8 8 8 9 9 9 0 0 
10 10 10 11 11 11 12 12 12 0 0 
13 13 13 14 14 14 15 15 15 0 0 
16 16 16 17 17 17 18 18 18 0 0 
19 19 19 20 20 20 21 21 21 0 0 
22 22 22 23 23 23 24 24 24 0 0 
25 25 25 26 26 26 27 27 27 0 0 
28 28 28 29 29 29 30 30 30 0 0 

1 1 1 2 2 2 3 3 3 0 
4 4 4 5 5 5 6 6 6 0 
7 7 7 8 8 8 9 9 9 0 
10 10 10 11 11 11 12 12 12 0 
13 13 13 14 14 14 15 15 15 0 
16 16 16 17 17 17 18 18 18 0 
19 19 19 20 20 20 21 21 21 0 
22 22 22 23 23 23 24 24 24 0 
25 25 25 26 26 26 27 27 27 0 
28 28 28 29 29 29 30 30 30 0 
31 31 31 32 32 32 33 33 33 0 
34 34 34 35 35 35 36 36 36 0 

1 1 1 2 2 2 3 3 3 4 4 4 0 
5 5 5 6 6 6 7 7 7 8 8 8 0 
9 9 9 10 10 10 11 11 11 12 12 12 0 
13 13 13 14 14 14 15 15 15 16 16 16 0 
17 17 17 18 18 18 19 19 19 20 20 20 0 
21 21 21 22 22 22 23 23 23 24 24 24 0 
25 25 25 26 26 26 27 27 27 28 28 28 0 
29 29 29 30 30 30 31 31 31 32 32 32 0 
33 33 33 34 34 34 35 35 35 36 36 36 0 
37 37 37 38 38 38 39 39 39 40 40 40 0 
41 41 41 42 42 42 43 43 43 44 44 44 0 
45 45 45 46 46 46 47 47 47 48 48 48 0 
49 49 49 50 50 50 51 51 51 52 52 52 0 

1 1 1 2 2 2 
3 3 3 4 4 4 
5 5 5 6 6 6 
7 7 7 8 8 8 
9 9 9 10 10 10 
11 11 11 12 12 12 
13 13 13 14 14 14 
15 15 15 16 16 16 
17 17 17 18 18 18 
19 19 19 20 20 20 
21 21 21 22 22 22 
23 23 23 24 24 24 
25 25 25 26 26 26 
27 27 27 28 28 28 
29 29 29 30 30 30 
31 31 31 32 32 32 
33 33 33 34 34 34 
35 35 35 36 36 36 

